#########
#########
##  # #E#
#S      #
#########
